小花园	палисадник , цветник (xiǎo huāyuán)
园	парк, сад, огород (yuán)
后边	задняя сторона, сзади, позади, за (hòubiān)
小	маленький (xiǎo)
花园	сад (huāyuán)
房子	дом (fángzi)
客厅	гостиная (kètīng)
厅	зал (tīng)
旁边	в стороне, сбоку, рядом, около (pángbiān)
书房	кабинет (shūfáng)
椅子	стул (yǐzi)
少	мало (shǎo)
桌子	стол (zhuōzi)
上边	наверху, на, над (shàngbiān)
总是	в любом случае, всегда, вообще (zǒngshì)
总	в любом случае, всегда, вообще (zǒng)
整理	приводить в порядок, упорядочивать (zhěnglǐ)
厨房	кухня (chúfáng)
对面	противоположная сторона (duìmiàn)
从	по, через (cóng)
帮助	помогать, помощь (bāngzhù)
帮	помогать (bāng)
餐厅	столовая (в квартире), ресторан (cāntīng)
左边	левая сторона, налево, слева (zuǒbiān)
里边	внутренняя сторона, внутри, в (lǐbiān)
房间	комната (fángjiān)
间	помещение, между (jiān)
卧室	спальня (wòshì)
洗澡间	ванная (xǐzǎojiān)
洗澡	купаться, принимать ванну (xǐzǎo)
洗	мыть, стирать (xǐ)
怎么样	как, как вам нравится (zěnmeyàng)
外边	снаружи, вне, за, вне дома (wàibiān)
下边	внизу, снизу, ниже, под (xiàbiān)
前边	перед, впереди (qiánbiān)
右边	правая сторона, направо, справа (yòubiān)
中间	середина, среди, между (zhōngjiān)